---------------------------------------------------------------------------------------------------------------------------------------------------------------------------------B----------------------
------------------------------------?????--o------------------------------------------------------------------------------------------------------------------------------------------------------------
----------------------------------------------------------------------o---------------------------------------------?-----------------------------------------------------------------------------------
------------------------------------------------------------------------------------------------------------------------------------------------------BBBBBBB-------------------------------------------
-------------------------------------------X------------------?----------?-----------------------------------------????????-----------------X-----------B----------------------------B------B-----------
------------------------------------------XX--------B--------------------------------------------------------------------------------------XX-----------------------------------------------------------
--------------------------M--------------XXX-----------------------------------------------------X----------------------------------------XXX--------------------X--------------------------------------
---------------------------------o------XXXX--------------------------------------------------------------------?--oXX----X--------------XXXX----?----------------------------------------X---------v---
---------T-----------------------------XXXXX---------------M--X--B-----------?-----BBBBBBBB------------XX---------------o---------------XXXXX----------------------M------------------------------T-f---
---------|----------------------------XXXXXX---------------------------------?---------------------------------------------------------XXXXXX-----------------------------------------------------|-f---
---------|------------------X--------XXXXXXX---------?-------------o--------B-------------B-------------------------------------------XXXXXXX-----------------------------------------------------|-f---
--M------|--------------------------XXXXXXXX------------------X---------------------------------?------------------------------------XXXXXXXX-------------------------------------------??--------|-f---
---------|-------------------------XXXXXXXXX----------------------------------------------------------------------------------------XXXXXXXXX---------------------X---------X---------------------|-f---
---------|------------------------XXXXXXXXXX---------------------------------------------------------------------------------------XXXXXXXXXX-----------------------------------------------------|-f---
m--------|------------------E----XXXXXXXXXXX----------------------B--------E------E---------------------E--------------------E----XXXXXXXXXXX-------------------------------------E---------------|-fE--
X-----XXX|XXXXXXXXXXXX--XXXXXXXXXXXXXXXXXXXXX-------XXXXXXXXXXXXXXXXXXXXXXXXXXXXX------------XXXXX------X-----XXXXX------XXXXXXXXXXXXXXXXXXXXXXXXXXXXXXXXXXXXXXXXXXXXXXXXXXXXXXXXXXXXXXXX---XXXXXX|XX--X
