-----X-------------B------o---------?-------B-X---?-----------------------?---------o--------E--------------------------------o------------------------------------------B------------------------------
--B------E------M-------E----------------B-------?-----B----------E---X-------------||------------T-------------------------M------------------T-------o---|--E------M-------?------------o-------------
-------------------|----o----------------------------------------------?---X--o--|--T--------------|-------------o--B--T-----------------------------?------------------------------------------EX------
------------------------------E---------------------------------------------------------|--------|--------------------------|-------------------X-------------------------------|----------|------------
----M---o-----B---|--------T--o----B--E----------E---?---------?----------------o-?-----------------X------------------------X-X?--------------------B------B--?-------------X-|?-M---o--------o--------
----M--B----------EMX|--------T------T----M---------?----T-------X--------------M--------------T--------------T-E---oM-----X-------|--?--M----------M--------?---B--|--------------------------T-?------
-------?---------E-------B--------------------X--------T----------?---M----X--------X-------------------T-X----------------------------E-?B----------------|------------M----M-------T------------------
--|-o----------------|----------|----BB-o------M-----------------------------------------------M-------------?M------XM--------B---------o---------------------------|----------------?-------------v---
----X-----------------------------------T-------B--------B--------B---E-------------------B---------T--------M--------T------------------|--------------------X---------X-M------E---------E-o-?----f---
--ME------------o---M-----------B------M-----------M---------------E-----|---?---------------------B------------------------|-----------o----------X-------------B-------|-----------------X--o-----f---
--------E--X------T---E-------o|---------------------B--------------|-------------------------------------------T------------------------M------T-----------------------M-----E|------|?------------f---
----------------B-X--B-------------------------------------------B------------------|----?---------o----------------------M------|------------------------MB--B--------------------------X----------f---
--------XT---o------------o---------------------------------E---------?--B----X---|---------o------------T------------------------------Eo---T-----?--M--------------------------B----|-----TB---B--f---
--------------M----|M----------------------------------------------------------------MM--------|--------------M-----------X-E-----------------T|------X--T-o---------------T------o--------------M--f---
m-o------X------------------------------------------------X---------T--o|----------------------?---------M------M-------------------E-----------X-----------------------------------------B---------f---
XXXXXXXXXXXXXXXXXXXXXXXXXXXXXXXXXXXXXXXXXXXXXXXXXXXXXXXXXXXXXXXXXXXXXXXXXXXXXXXXXXXXXXXXXXXXXXXXXXXXXXXXXXXXXXXXXXXXXXXXXXXXXXXXXXXXXXXXXXXXXXXXXXXXXXXXXXXXXXXXXXXXXXXXXXXXXXXXXXXXXXXXXXXXXXXXXXXXXXXX
